Acidobacterium	M
Agrobacterium	M
Aquifex	M
Bacillus	M
Bacteroides	N
Bdellovibrio	M
Bifidobacterium	N
Blochmannia	N
Bordetella	M
Borrelia	M
Bradyrhizobium	M
Brucella	M
Buchnera	-
Campylobacter	M
Caulobacter	M
Chlamydophila	-
Chlorobaculum	N
Chromobacterium	M
Clostridium	M
Corynebacterium	N
Coxiella	N
Dehalococcoides	N
Deinococcus	N
Desulfovibrio	M
Enterococcus	N
Escherichia	M
Fibrobacter	N
Fusobacterium	N
Gemmata	M
Geobacter	M
Gloeobacter	N
Haemophilus	N
Helicobacter	M
Lactobacillus	N
Lactococcus	N
Leptospira	M
Listeria	M
Mycobacterium	N
Neisseria	N
Nitrosomonas	M
Nostoc	N
Oceanobacillus	M
Pasteurella	N
Photobacterium	M
Photorhabdus	M
Porphyromonas	N
Prochlorococcus	N
Pseudomonas	M
Ralstonia	M
Mesorhizobium	M
Rhodopirellula	M
Rhodopseudomonas	M
Rickettsia	N
Salmonella	M
Shewanella	M
Shigella	M
Staphylococcus	N
Streptococcus	N
Streptomyces	N
Synechococcus	N
Synechocystis	N
Caldanaerobacter	M
Thermotoga	M
Thermus	N
Treponema	M
Tropheryma	N
Ureaplasma	N
Vibrio	M
Wigglesworthia	M
Wolbachia	N
Wolinella	M
Xanthomonas	M
Xylella	N
Yersinia	M
